¡ö¡¡¡ö¡ö¡ö¡ö¡ö¡ö¡ö¡ö¡ö¡ö¡ö¡ö¡ö¡ö¡ö¡ö¡ö¡ö¡ö¡ö¡ö¡ö¡ö¡ö¡ö¡ö¡ö¡ö¡ö¡ö¡ö¡ö¡ö¡ö¡ö¡ö¡ö¡ö¡ö¡ö¡ö¡ö¡ö¡ö¡ö¡ö¡ö¡ö¡ö¡ö¡ö¡ö¡ö¡ö¡ö¡ö¡ö¡ö¡ö¡ö¡ö¡ö¡ö¡ö¡ö¡ö¡ö¡ö¡ö¡ö¡ö¡ö¡ö¡ö¡ö¡ö¡ö¡ö¡ö¡ö¡ö¡ö¡ö¡ö¡ö¡ö¡ö¡ö¡ö¡ö¡ö¡ö¡ö¡ö¡ö¡ö¡ö¡ö¡ö
¡ö¡¡¡¡¡¡¡¡¡¡¡¡¡¡¡¡¡¡¡¡¡¡¡¡¡¡¡¡¡¡¡ö¡¡¡ö¡¡¡¡¡¡¡ö¡¡¡¡¡¡¡¡¡¡¡ö¡¡¡¡¡¡¡¡¡¡¡¡¡¡¡¡¡¡¡¡¡¡¡¡¡¡¡¡¡¡¡¡¡¡¡¡¡¡¡ö¡¡¡ö¡¡¡¡¡¡¡ö¡¡¡ö¡¡¡¡¡¡¡¡¡¡¡¡¡¡¡¡¡¡¡¡¡¡¡¡¡¡¡¡¡¡¡ö¡¡¡ö¡¡¡¡¡¡¡¡¡¡¡¡¡¡¡¡¡¡¡ö¡¡¡¡¡¡¡¡¡¡¡¡¡¡¡¡¡¡¡ö¡¡¡ö¡¡¡¡¡¡¡ö
¡ö¡¡¡ö¡¡¡ö¡ö¡ö¡ö¡ö¡¡¡ö¡¡¡ö¡¡¡ö¡ö¡ö¡¡¡ö¡¡¡ö¡ö¡ö¡¡¡ö¡ö¡ö¡¡¡ö¡¡¡ö¡ö¡ö¡ö¡ö¡ö¡ö¡ö¡ö¡ö¡ö¡ö¡ö¡ö¡ö¡ö¡ö¡ö¡ö¡¡¡ö¡¡¡ö¡¡¡ö¡¡¡ö¡¡¡ö¡ö¡ö¡ö¡ö¡ö¡ö¡ö¡ö¡ö¡ö¡ö¡ö¡¡¡ö¡¡¡ö¡¡¡ö¡ö¡ö¡ö¡ö¡ö¡ö¡ö¡ö¡¡¡ö¡ö¡ö¡ö¡ö¡ö¡ö¡ö¡ö¡¡¡ö¡¡¡ö¡¡¡ö
¡ö¡¡¡ö¡¡¡¡¡¡¡¡¡¡¡ö¡¡¡ö¡¡¡ö¡¡¡¡¡¡¡ö¡¡¡ö¡¡¡¡¡¡¡¡¡¡¡¡¡¡¡ö¡¡¡¡¡¡¡¡¡¡¡¡¡¡¡¡¡¡¡¡¡¡¡¡¡¡¡¡¡¡¡ö¡¡¡¡¡¡¡¡¡¡¡¡¡¡¡¡¡¡¡ö¡¡¡¡¡¡¡¡¡¡¡¡¡¡¡¡¡¡¡¡¡¡¡¡¡¡¡ö¡¡¡¡¡¡¡ö¡¡¡¡¡¡¡¡¡¡¡¡¡¡¡¡¡¡¡¡¡¡¡ö¡¡¡ö¡¡¡ö¡¡¡¡¡¡¡ö¡¡¡ö¡¡¡ö¡¡¡¡¡¡¡ö¡¡¡ö
¡ö¡¡¡ö¡ö¡ö¡¡¡ö¡¡¡ö¡ö¡ö¡ö¡ö¡ö¡ö¡ö¡ö¡¡¡ö¡¡¡ö¡ö¡ö¡ö¡ö¡ö¡ö¡ö¡ö¡ö¡ö¡¡¡ö¡ö¡ö¡ö¡ö¡ö¡ö¡ö¡ö¡ö¡ö¡¡¡ö¡¡¡ö¡ö¡ö¡ö¡ö¡¡¡ö¡ö¡ö¡ö¡ö¡ö¡ö¡ö¡ö¡ö¡ö¡ö¡ö¡ö¡ö¡¡¡ö¡ö¡ö¡ö¡ö¡ö¡ö¡ö¡ö¡ö¡ö¡ö¡ö¡ö¡ö¡¡¡ö¡¡¡ö¡¡¡ö¡ö¡ö¡¡¡ö¡¡¡ö¡¡¡ö¡ö¡ö¡ö¡ö
¡ö¡¡¡¡¡¡¡ö¡¡¡ö¡¡¡¡¡¡¡¡¡¡¡¡¡¡¡¡¡¡¡¡¡¡¡¡¡¡¡¡¡¡¡¡¡¡¡¡¡¡¡ö¡¡¡ö¡¡¡ö¡¡¡¡¡¡¡¡¡¡¡¡¡¡¡ö¡¡¡ö¡¡¡¡¡¡¡ö¡¡¡¡¡¡¡ö¡¡¡¡¡¡¡¡¡¡¡ö¡¡¡ö¡¡¡ö¡¡¡¡¡¡¡¡¡¡¡¡¡¡¡¡¡¡¡¡¡¡¡ö¡¡¡¡¡¡¡¡¡¡¡¡¡¡¡¡¡¡¡ö¡¡¡¡¡¡¡¡¡¡¡¡¡¡¡¡¡¡¡ö¡¡¡¡¡¡¡¡¡¡¡¡¡¡¡¡¡¡¡ö
¡ö¡ö¡ö¡¡¡ö¡¡¡ö¡ö¡ö¡ö¡ö¡ö¡ö¡ö¡ö¡¡¡ö¡ö¡ö¡¡¡ö¡ö¡ö¡ö¡ö¡ö¡ö¡¡¡ö¡¡¡ö¡ö¡ö¡ö¡ö¡ö¡ö¡ö¡ö¡¡¡ö¡¡¡ö¡ö¡ö¡ö¡ö¡ö¡ö¡ö¡ö¡ö¡ö¡¡¡ö¡¡¡ö¡¡¡ö¡¡¡ö¡ö¡ö¡ö¡ö¡¡¡ö¡¡¡ö¡ö¡ö¡¡¡ö¡ö¡ö¡ö¡ö¡ö¡ö¡ö¡ö¡¡¡ö¡ö¡ö¡ö¡ö¡ö¡ö¡ö¡ö¡¡¡ö¡ö¡ö¡ö¡ö¡ö¡ö¡¡¡ö
¡ö¡¡¡¡¡¡¡ö¡¡¡¡¡¡¡¡¡¡¡¡¡¡¡¡¡¡¡ö¡¡¡¡¡¡¡ö¡¡¡¡¡¡¡¡¡¡¡¡¡¡¡ö¡¡¡¡¡¡¡¡¡¡¡¡¡¡¡ö¡¡¡¡¡¡¡¡¡¡¡¡¡¡¡ö¡¡¡ö¡¡¡¡¡¡¡ö¡¡¡¡¡¡¡ö¡¡¡¡¡¡¡¡¡¡¡¡¡¡¡¡¡¡¡¡¡¡¡ö¡¡¡ö¡¡¡ö¡¡¡¡¡¡¡¡¡¡¡ö¡¡¡ö¡¡¡¡¡¡¡¡¡¡¡¡¡¡¡¡¡¡¡¡¡¡¡¡¡¡¡¡¡¡¡¡¡¡¡¡¡¡¡¡¡¡¡ö¡¡¡ö
¡ö¡¡¡ö¡¡¡ö¡ö¡ö¡ö¡ö¡ö¡ö¡ö¡ö¡ö¡ö¡ö¡ö¡ö¡ö¡ö¡ö¡ö¡ö¡¡¡ö¡ö¡ö¡¡¡ö¡ö¡ö¡ö¡ö¡ö¡ö¡¡¡ö¡ö¡ö¡ö¡ö¡ö¡ö¡¡¡ö¡¡¡ö¡ö¡ö¡¡¡ö¡ö¡ö¡ö¡ö¡ö¡ö¡¡¡ö¡ö¡ö¡ö¡ö¡¡¡ö¡ö¡ö¡ö¡ö¡¡¡ö¡ö¡ö¡ö¡ö¡¡¡ö¡¡¡ö¡ö¡ö¡¡¡ö¡¡¡ö¡ö¡ö¡¡¡ö¡ö¡ö¡ö¡ö¡ö¡ö¡ö¡ö¡ö¡ö¡ö¡ö
¡ö¡¡¡ö¡¡¡¡¡¡¡¡¡¡¡¡¡¡¡¡¡¡¡¡¡¡¡¡¡¡¡¡¡¡¡¡¡¡¡¡¡¡¡ö¡¡¡¡¡¡¡¡¡¡¡¡¡¡¡ö¡¡¡¡¡¡¡¡¡¡¡¡¡¡¡¡¡¡¡ö¡¡¡ö¡¡¡¡¡¡¡¡¡¡¡¡¡¡¡ö¡¡¡¡¡¡¡¡¡¡¡ö¡¡¡¡¡¡¡¡¡¡¡ö¡¡¡¡¡¡¡¡¡¡¡ö¡¡¡¡¡¡¡¡¡¡¡¡¡¡¡¡¡¡¡¡¡¡¡ö¡¡¡ö¡¡¡¡¡¡¡ö¡¡¡¡¡¡¡ö¡¡¡ö¡¡¡¡¡¡¡¡¡¡¡¡¡¡¡ö
¡ö¡¡¡ö¡¡¡ö¡ö¡ö¡ö¡ö¡¡¡ö¡ö¡ö¡ö¡ö¡¡¡ö¡ö¡ö¡¡¡ö¡ö¡ö¡ö¡ö¡ö¡ö¡ö¡ö¡ö¡ö¡¡¡ö¡ö¡ö¡ö¡ö¡ö¡ö¡ö¡ö¡¡¡ö¡¡¡ö¡ö¡ö¡ö¡ö¡ö¡ö¡¡¡ö¡ö¡ö¡ö¡ö¡ö¡ö¡ö¡ö¡¡¡ö¡ö¡ö¡ö¡ö¡ö¡ö¡¡¡ö¡ö¡ö¡¡¡ö¡ö¡ö¡ö¡ö¡ö¡ö¡ö¡ö¡ö¡ö¡ö¡ö¡ö¡ö¡ö¡ö¡¡¡ö¡¡¡ö¡ö¡ö¡ö¡ö¡ö¡ö
¡ö¡¡¡ö¡¡¡¡¡¡¡¡¡¡¡ö¡¡¡¡¡¡¡¡¡¡¡ö¡¡¡¡¡¡¡ö¡¡¡ö¡¡¡ö¡¡¡ö¡¡¡¡¡¡¡¡¡¡¡¡¡¡¡¡¡¡¡¡¡¡¡¡¡¡¡¡¡¡¡¡¡¡¡¡¡¡¡¡¡¡¡¡¡¡¡¡¡¡¡¡¡¡¡¡¡¡¡ö¡¡¡¡¡¡¡¡¡¡¡ö¡¡¡¡¡¡¡ö¡¡¡¡¡¡¡¡¡¡¡¡¡¡¡ö¡¡¡¡¡¡¡¡¡¡¡ö¡¡¡¡¡¡¡¡¡¡¡ö¡¡¡¡¡¡¡¡¡¡¡¡¡¡¡¡¡¡¡ö¡¡¡¡¡¡¡¡¡¡¡ö
¡ö¡¡¡ö¡¡¡ö¡¡¡ö¡ö¡ö¡ö¡ö¡ö¡ö¡ö¡ö¡ö¡ö¡ö¡ö¡ö¡ö¡¡¡ö¡¡¡ö¡¡¡ö¡ö¡ö¡¡¡ö¡¡¡ö¡ö¡ö¡ö¡ö¡ö¡ö¡ö¡ö¡ö¡ö¡ö¡ö¡ö¡ö¡¡¡ö¡ö¡ö¡ö¡ö¡ö¡ö¡¡¡ö¡ö¡ö¡¡¡ö¡ö¡ö¡ö¡ö¡¡¡ö¡ö¡ö¡ö¡ö¡ö¡ö¡¡¡ö¡ö¡ö¡ö¡ö¡¡¡ö¡ö¡ö¡ö¡ö¡¡¡ö¡ö¡ö¡ö¡ö¡ö¡ö¡¡¡ö¡¡¡ö¡ö¡ö¡ö¡ö
¡ö¡¡¡ö¡¡¡ö¡¡¡¡¡¡¡¡¡¡¡¡¡¡¡¡¡¡¡¡¡¡¡¡¡¡¡ö¡¡¡¡¡¡¡¡¡¡¡ö¡¡¡¡¡¡¡ö¡¡¡ö¡¡¡¡¡¡¡¡¡¡¡¡¡¡¡ö¡¡¡ö¡¡¡¡¡¡¡¡¡¡¡ö¡¡¡¡¡¡¡ö¡¡¡¡¡¡¡ö¡¡¡ö¡¡¡ö¡¡¡¡¡¡¡¡¡¡¡ö¡¡¡¡¡¡¡ö¡¡¡¡¡¡¡ö¡¡¡ö¡¡¡ö¡¡¡ö¡¡¡¡¡¡¡¡¡¡¡¡¡¡¡¡¡¡¡ö¡¡¡¡¡¡¡ö¡¡¡¡¡¡¡¡¡¡¡ö¡¡¡ö
¡ö¡ö¡ö¡¡¡ö¡¡¡ö¡¡¡ö¡¡¡ö¡ö¡ö¡ö¡ö¡ö¡ö¡ö¡ö¡¡¡ö¡ö¡ö¡ö¡ö¡¡¡ö¡ö¡ö¡ö¡ö¡ö¡ö¡ö¡ö¡ö¡ö¡ö¡ö¡¡¡ö¡¡¡ö¡ö¡ö¡ö¡ö¡ö¡ö¡ö¡ö¡¡¡ö¡ö¡ö¡¡¡ö¡¡¡ö¡ö¡ö¡ö¡ö¡ö¡ö¡¡¡ö¡ö¡ö¡¡¡ö¡ö¡ö¡ö¡ö¡¡¡ö¡¡¡ö¡¡¡ö¡¡¡ö¡¡¡ö¡¡¡ö¡ö¡ö¡¡¡ö¡ö¡ö¡ö¡ö¡ö¡ö¡ö¡ö¡¡¡ö
¡ö¡¡¡¡¡¡¡ö¡¡¡ö¡¡¡ö¡¡¡¡¡¡¡¡¡¡¡¡¡¡¡ö¡¡¡ö¡¡¡¡¡¡¡¡¡¡¡¡¡¡¡ö¡¡¡¡¡¡¡ö¡¡¡¡¡¡¡¡¡¡¡ö¡¡¡¡¡¡¡¡¡¡¡¡¡¡¡¡¡¡¡¡¡¡¡¡¡¡¡¡¡¡¡¡¡¡¡¡¡¡¡¡¡¡¡¡¡¡¡ö¡¡¡ö¡¡¡¡¡¡¡¡¡¡¡¡¡¡¡¡¡¡¡¡¡¡¡ö¡¡¡ö¡¡¡ö¡¡¡ö¡¡¡ö¡¡¡ö¡¡¡¡¡¡¡¡¡¡¡¡¡¡¡¡¡¡¡¡¡¡¡¡¡¡¡ö¡¡¡ö
¡ö¡¡¡ö¡ö¡ö¡¡¡ö¡¡¡ö¡ö¡ö¡ö¡ö¡ö¡ö¡ö¡ö¡¡¡ö¡¡¡ö¡ö¡ö¡¡¡ö¡ö¡ö¡¡¡ö¡ö¡ö¡¡¡ö¡¡¡ö¡ö¡ö¡¡¡ö¡ö¡ö¡ö¡ö¡¡¡ö¡¡¡ö¡¡¡ö¡ö¡ö¡ö¡ö¡ö¡ö¡ö¡ö¡ö¡ö¡ö¡ö¡¡¡ö¡¡¡ö¡ö¡ö¡ö¡ö¡ö¡ö¡ö¡ö¡ö¡ö¡¡¡ö¡¡¡ö¡¡¡ö¡ö¡ö¡ö¡ö¡ö¡ö¡ö¡ö¡ö¡ö¡ö¡ö¡¡¡ö¡ö¡ö¡ö¡ö¡¡¡ö
¡ö¡¡¡ö¡¡¡¡¡¡¡ö¡¡¡ö¡¡¡¡¡¡¡¡¡¡¡¡¡¡¡¡¡¡¡¡¡¡¡¡¡¡¡ö¡¡¡¡¡¡¡¡¡¡¡ö¡¡¡¡¡¡¡ö¡¡¡¡¡¡¡¡¡¡¡¡¡¡¡ö¡¡¡ö¡¡¡ö¡¡¡ö¡¡¡¡¡¡¡¡¡¡¡ö¡¡¡¡¡¡¡ö¡¡¡ö¡¡¡¡¡¡¡¡¡¡¡¡¡¡¡¡¡¡¡¡¡¡¡ö¡¡¡¡¡¡¡ö¡¡¡ö¡¡¡ö¡¡¡ö¡¡¡¡¡¡¡¡¡¡¡¡¡¡¡ö¡¡¡ö¡¡¡ö¡¡¡¡¡¡¡¡¡¡¡¡¡¡¡ö
¡ö¡¡¡ö¡ö¡ö¡¡¡ö¡¡¡ö¡¡¡ö¡ö¡ö¡ö¡ö¡ö¡ö¡¡¡ö¡ö¡ö¡ö¡ö¡ö¡ö¡ö¡ö¡ö¡ö¡¡¡ö¡¡¡ö¡¡¡ö¡ö¡ö¡¡¡ö¡ö¡ö¡¡¡ö¡ö¡ö¡¡¡ö¡¡¡ö¡ö¡ö¡ö¡ö¡¡¡ö¡ö¡ö¡¡¡ö¡¡¡ö¡¡¡ö¡ö¡ö¡ö¡ö¡ö¡ö¡ö¡ö¡¡¡ö¡ö¡ö¡¡¡ö¡¡¡ö¡¡¡ö¡¡¡ö¡ö¡ö¡¡¡ö¡¡¡ö¡¡¡ö¡¡¡ö¡¡¡ö¡¡¡ö¡ö¡ö¡ö¡ö
¡ö¡¡¡ö¡¡¡¡¡¡¡ö¡¡¡¡¡¡¡¡¡¡¡¡¡¡¡¡¡¡¡ö¡¡¡¡¡¡¡¡¡¡¡¡¡¡¡¡¡¡¡¡¡¡¡¡¡¡¡ö¡¡¡ö¡¡¡¡¡¡¡ö¡¡¡ö¡¡¡¡¡¡¡¡¡¡¡ö¡¡¡ö¡¡¡¡¡¡¡¡¡¡¡ö¡¡¡¡¡¡¡¡¡¡¡¡¡¡¡ö¡¡¡¡¡¡¡¡¡¡¡¡¡¡¡ö¡¡¡ö¡¡¡¡¡¡¡¡¡¡¡ö¡¡¡¡¡¡¡¡¡¡¡¡¡¡¡ö¡¡¡ö¡¡¡¡¡¡¡¡¡¡¡ö¡¡¡ö¡¡¡ö¡¡¡¡¡¡¡ö
¡ö¡¡¡ö¡ö¡ö¡¡¡ö¡¡¡ö¡ö¡ö¡¡¡ö¡¡¡ö¡¡¡ö¡ö¡ö¡ö¡ö¡ö¡ö¡ö¡ö¡ö¡ö¡ö¡ö¡ö¡ö¡ö¡ö¡¡¡ö¡ö¡ö¡ö¡ö¡¡¡ö¡ö¡ö¡ö¡ö¡ö¡ö¡ö¡ö¡ö¡ö¡ö¡ö¡ö¡ö¡¡¡ö¡ö¡ö¡ö¡ö¡ö¡ö¡ö¡ö¡ö¡ö¡ö¡ö¡¡¡ö¡¡¡ö¡ö¡ö¡ö¡ö¡¡¡ö¡ö¡ö¡ö¡ö¡ö¡ö¡ö¡ö¡ö¡ö¡¡¡ö¡ö¡ö¡ö¡ö¡ö¡ö¡¡¡ö¡ö¡ö
¡ö¡¡¡ö¡¡¡¡¡¡¡ö¡¡¡¡¡¡¡ö¡¡¡ö¡¡¡ö¡¡¡¡¡¡¡¡¡¡¡¡¡¡¡¡¡¡¡ö¡¡¡¡¡¡¡¡¡¡¡¡¡¡¡ö¡¡¡¡¡¡¡¡¡¡¡¡¡¡¡¡¡¡¡¡¡¡¡¡¡¡¡ö¡¡¡¡¡¡¡ö¡¡¡ö¡¡¡ö¡¡¡¡¡¡¡¡¡¡¡ö¡¡¡ö¡¡¡¡¡¡¡ö¡¡¡ö¡¡¡¡¡¡¡ö¡¡¡¡¡¡¡ö¡¡¡ö¡¡¡¡¡¡¡¡¡¡¡ö¡¡¡ö¡¡¡ö¡¡¡¡¡¡¡¡¡¡¡¡¡¡¡¡¡¡¡ö¡¡¡ö
¡ö¡ö¡ö¡¡¡ö¡ö¡ö¡¡¡ö¡¡¡ö¡ö¡ö¡¡¡ö¡ö¡ö¡ö¡ö¡ö¡ö¡ö¡ö¡ö¡ö¡¡¡ö¡ö¡ö¡ö¡ö¡ö¡ö¡ö¡ö¡ö¡ö¡ö¡ö¡¡¡ö¡ö¡ö¡ö¡ö¡ö¡ö¡¡¡ö¡¡¡ö¡¡¡ö¡¡¡ö¡¡¡ö¡ö¡ö¡ö¡ö¡¡¡ö¡¡¡ö¡ö¡ö¡¡¡ö¡¡¡ö¡ö¡ö¡¡¡ö¡ö¡ö¡¡¡ö¡¡¡ö¡ö¡ö¡ö¡ö¡¡¡ö¡¡¡ö¡ö¡ö¡ö¡ö¡ö¡ö¡ö¡ö¡ö¡ö¡¡¡ö
¡ö¡¡¡¡¡¡¡ö¡¡¡¡¡¡¡ö¡¡¡¡¡¡¡ö¡¡¡¡¡¡¡¡¡¡¡¡¡¡¡ö¡¡¡ö¡¡¡¡¡¡¡ö¡¡¡¡¡¡¡¡¡¡¡¡¡¡¡¡¡¡¡¡¡¡¡ö¡¡¡ö¡¡¡¡¡¡¡ö¡¡¡¡¡¡¡ö¡¡¡¡¡¡¡ö¡¡¡¡¡¡¡¡¡¡¡ö¡¡¡ö¡¡¡ö¡¡¡ö¡¡¡¡¡¡¡¡¡¡¡ö¡¡¡¡¡¡¡ö¡¡¡ö¡¡¡ö¡¡¡¡¡¡¡¡¡¡¡¡¡¡¡¡¡¡¡¡¡¡¡¡¡¡¡¡¡¡¡ö¡¡¡ö¡¡¡¡¡¡¡ö
¡ö¡¡¡ö¡¡¡ö¡¡¡ö¡¡¡ö¡ö¡ö¡ö¡ö¡¡¡ö¡¡¡ö¡¡¡ö¡ö¡ö¡¡¡ö¡¡¡ö¡ö¡ö¡¡¡ö¡ö¡ö¡ö¡ö¡ö¡ö¡ö¡ö¡ö¡ö¡ö¡ö¡ö¡ö¡¡¡ö¡¡¡ö¡ö¡ö¡ö¡ö¡ö¡ö¡ö¡ö¡¡¡ö¡ö¡ö¡¡¡ö¡¡¡ö¡¡¡ö¡¡¡ö¡ö¡ö¡ö¡ö¡¡¡ö¡ö¡ö¡¡¡ö¡¡¡ö¡¡¡ö¡ö¡ö¡ö¡ö¡¡¡ö¡ö¡ö¡ö¡ö¡ö¡ö¡ö¡ö¡¡¡ö¡¡¡ö¡ö¡ö
¡ö¡¡¡ö¡¡¡ö¡¡¡ö¡¡¡¡¡¡¡¡¡¡¡ö¡¡¡ö¡¡¡ö¡¡¡¡¡¡¡¡¡¡¡¡¡¡¡¡¡¡¡¡¡¡¡¡¡¡¡¡¡¡¡¡¡¡¡ö¡¡¡¡¡¡¡¡¡¡¡¡¡¡¡¡¡¡¡¡¡¡¡¡¡¡¡¡¡¡¡¡¡¡¡¡¡¡¡¡¡¡¡¡¡¡¡ö¡¡¡¡¡¡¡¡¡¡¡ö¡¡¡ö¡¡¡¡¡¡¡ö¡¡¡¡¡¡¡¡¡¡¡¡¡¡¡¡¡¡¡¡¡¡¡¡¡¡¡ö¡¡¡ö¡¡¡¡¡¡¡¡¡¡¡ö¡¡¡¡¡¡¡ö¡¡¡¡¡¡¡ö
¡ö¡ö¡ö¡¡¡ö¡¡¡ö¡¡¡ö¡ö¡ö¡¡¡ö¡ö¡ö¡¡¡ö¡¡¡ö¡¡¡ö¡¡¡ö¡¡¡ö¡ö¡ö¡¡¡ö¡¡¡ö¡ö¡ö¡ö¡ö¡¡¡ö¡¡¡ö¡¡¡ö¡ö¡ö¡¡¡ö¡¡¡ö¡ö¡ö¡ö¡ö¡ö¡ö¡ö¡ö¡ö¡ö¡¡¡ö¡¡¡ö¡ö¡ö¡ö¡ö¡¡¡ö¡¡¡ö¡ö¡ö¡¡¡ö¡ö¡ö¡ö¡ö¡¡¡ö¡ö¡ö¡ö¡ö¡ö¡ö¡ö¡ö¡ö¡ö¡¡¡ö¡ö¡ö¡¡¡ö¡ö¡ö¡ö¡ö¡¡¡ö
¡ö¡¡¡¡¡¡¡ö¡¡¡ö¡¡¡ö¡¡¡¡¡¡¡¡¡¡¡ö¡¡¡ö¡¡¡ö¡¡¡ö¡¡¡ö¡¡¡ö¡¡¡¡¡¡¡ö¡¡¡¡¡¡¡¡¡¡¡¡¡¡¡ö¡¡¡ö¡¡¡ö¡¡¡ö¡¡¡ö¡¡¡¡¡¡¡ö¡¡¡ö¡¡¡ö¡¡¡¡¡¡¡ö¡¡¡¡¡¡¡¡¡¡¡¡¡¡¡¡¡¡¡¡¡¡¡¡¡¡¡¡¡¡¡¡¡¡¡ö¡¡¡ö¡¡¡¡¡¡¡¡¡¡¡¡¡¡¡¡¡¡¡¡¡¡¡¡¡¡¡¡¡¡¡¡¡¡¡¡¡¡¡ö¡¡¡¡¡¡¡ö
¡ö¡ö¡ö¡¡¡ö¡ö¡ö¡¡¡ö¡¡¡ö¡ö¡ö¡¡¡ö¡¡¡ö¡¡¡ö¡ö¡ö¡¡¡ö¡ö¡ö¡¡¡ö¡ö¡ö¡¡¡ö¡ö¡ö¡¡¡ö¡ö¡ö¡ö¡ö¡¡¡ö¡¡¡ö¡ö¡ö¡¡¡ö¡¡¡ö¡¡¡ö¡¡¡ö¡¡¡ö¡ö¡ö¡ö¡ö¡ö¡ö¡ö¡ö¡ö¡ö¡ö¡ö¡ö¡ö¡ö¡ö¡ö¡ö¡ö¡ö¡¡¡ö¡ö¡ö¡ö¡ö¡ö¡ö¡ö¡ö¡¡¡ö¡ö¡ö¡ö¡ö¡ö¡ö¡ö¡ö¡ö¡ö¡¡¡ö¡¡¡ö
¡ö¡¡¡¡¡¡¡¡¡¡¡ö¡¡¡ö¡¡¡¡¡¡¡ö¡¡¡ö¡¡¡ö¡¡¡¡¡¡¡ö¡¡¡¡¡¡¡ö¡¡¡¡¡¡¡ö¡¡¡¡¡¡¡ö¡¡¡¡¡¡¡¡¡¡¡ö¡¡¡¡¡¡¡¡¡¡¡ö¡¡¡ö¡¡¡¡¡¡¡¡¡¡¡¡¡¡¡¡¡¡¡¡¡¡¡¡¡¡¡¡¡¡¡¡¡¡¡¡¡¡¡¡¡¡¡¡¡¡¡¡¡¡¡¡¡¡¡¡¡¡¡¡¡¡¡¡¡¡¡ö¡¡¡¡¡¡¡ö¡¡¡¡¡¡¡¡¡¡¡¡¡¡¡¡¡¡¡¡¡¡¡¡¡¡¡ö¡¡¡ö
¡ö¡¡¡ö¡¡¡ö¡¡¡ö¡¡¡ö¡ö¡ö¡¡¡ö¡¡¡ö¡¡¡ö¡¡¡ö¡¡¡ö¡ö¡ö¡¡¡ö¡ö¡ö¡¡¡ö¡¡¡ö¡ö¡ö¡ö¡ö¡ö¡ö¡ö¡ö¡ö¡ö¡ö¡ö¡ö¡ö¡¡¡ö¡ö¡ö¡ö¡ö¡ö¡ö¡¡¡ö¡ö¡ö¡ö¡ö¡¡¡ö¡¡¡ö¡ö¡ö¡¡¡ö¡ö¡ö¡ö¡ö¡¡¡ö¡ö¡ö¡ö¡ö¡ö¡ö¡ö¡ö¡¡¡ö¡ö¡ö¡ö¡ö¡ö¡ö¡¡¡ö¡ö¡ö¡ö¡ö¡ö¡ö¡¡¡ö¡ö¡ö
¡ö¡¡¡ö¡¡¡ö¡¡¡ö¡¡¡ö¡¡¡¡¡¡¡ö¡¡¡ö¡¡¡ö¡¡¡ö¡¡¡¡¡¡¡ö¡¡¡ö¡¡¡ö¡¡¡ö¡¡¡¡¡¡¡¡¡¡¡¡¡¡¡¡¡¡¡¡¡¡¡¡¡¡¡¡¡¡¡ö¡¡¡¡¡¡¡¡¡¡¡¡¡¡¡ö¡¡¡¡¡¡¡¡¡¡¡ö¡¡¡ö¡¡¡ö¡¡¡¡¡¡¡¡¡¡¡¡¡¡¡ö¡¡¡¡¡¡¡¡¡¡¡¡¡¡¡ö¡¡¡¡¡¡¡ö¡¡¡¡¡¡¡ö¡¡¡¡¡¡¡¡¡¡¡¡¡¡¡¡¡¡¡ö¡¡¡¡¡¡¡ö
¡ö¡¡¡ö¡¡¡ö¡ö¡ö¡ö¡ö¡¡¡ö¡ö¡ö¡ö¡ö¡¡¡ö¡¡¡ö¡¡¡ö¡ö¡ö¡¡¡ö¡¡¡ö¡ö¡ö¡¡¡ö¡ö¡ö¡¡¡ö¡¡¡ö¡ö¡ö¡ö¡ö¡ö¡ö¡¡¡ö¡¡¡ö¡ö¡ö¡¡¡ö¡¡¡ö¡ö¡ö¡ö¡ö¡ö¡ö¡¡¡ö¡¡¡ö¡¡¡ö¡ö¡ö¡¡¡ö¡¡¡ö¡ö¡ö¡ö¡ö¡¡¡ö¡¡¡ö¡¡¡ö¡ö¡ö¡¡¡ö¡ö¡ö¡ö¡ö¡ö¡ö¡ö¡ö¡ö¡ö¡¡¡ö¡ö¡ö¡¡¡ö
¡ö¡¡¡ö¡¡¡¡¡¡¡¡¡¡¡ö¡¡¡¡¡¡¡ö¡¡¡¡¡¡¡ö¡¡¡ö¡¡¡ö¡¡¡ö¡¡¡¡¡¡¡¡¡¡¡ö¡¡¡¡¡¡¡ö¡¡¡ö¡¡¡¡¡¡¡¡¡¡¡¡¡¡¡ö¡¡¡ö¡¡¡¡¡¡¡ö¡¡¡ö¡¡¡¡¡¡¡ö¡¡¡¡¡¡¡ö¡¡¡ö¡¡¡ö¡¡¡¡¡¡¡ö¡¡¡ö¡¡¡¡¡¡¡ö¡¡¡¡¡¡¡ö¡¡¡¡¡¡¡¡¡¡¡¡¡¡¡¡¡¡¡¡¡¡¡¡¡¡¡¡¡¡¡¡¡¡¡ö¡¡¡ö¡¡¡¡¡¡¡ö
¡ö¡ö¡ö¡ö¡ö¡¡¡ö¡ö¡ö¡ö¡ö¡¡¡ö¡¡¡ö¡ö¡ö¡ö¡ö¡¡¡ö¡¡¡ö¡ö¡ö¡ö¡ö¡¡¡ö¡¡¡ö¡¡¡ö¡¡¡ö¡ö¡ö¡ö¡ö¡¡¡ö¡¡¡ö¡ö¡ö¡ö¡ö¡ö¡ö¡ö¡ö¡ö¡ö¡ö¡ö¡¡¡ö¡ö¡ö¡ö¡ö¡ö¡ö¡ö¡ö¡ö¡ö¡¡¡ö¡¡¡ö¡ö¡ö¡ö¡ö¡¡¡ö¡ö¡ö¡¡¡ö¡ö¡ö¡ö¡ö¡¡¡ö¡ö¡ö¡ö¡ö¡¡¡ö¡ö¡ö¡ö¡ö¡ö¡ö¡ö¡ö
¡ö¡¡¡¡¡¡¡¡¡¡¡¡¡¡¡¡¡¡¡ö¡¡¡ö¡¡¡ö¡¡¡¡¡¡¡¡¡¡¡¡¡¡¡¡¡¡¡¡¡¡¡ö¡¡¡ö¡¡¡ö¡¡¡ö¡¡¡¡¡¡¡¡¡¡¡ö¡¡¡ö¡¡¡¡¡¡¡¡¡¡¡¡¡¡¡¡¡¡¡¡¡¡¡¡¡¡¡¡¡¡¡¡¡¡¡¡¡¡¡¡¡¡¡¡¡¡¡¡¡¡¡ö¡¡¡ö¡¡¡¡¡¡¡¡¡¡¡ö¡¡¡¡¡¡¡ö¡¡¡¡¡¡¡¡¡¡¡ö¡¡¡¡¡¡¡ö¡¡¡ö¡¡¡¡¡¡¡¡¡¡¡¡¡¡¡¡¡¡¡ö
¡ö¡¡¡ö¡¡¡ö¡¡¡ö¡ö¡ö¡¡¡ö¡¡¡ö¡ö¡ö¡ö¡ö¡¡¡ö¡ö¡ö¡ö¡ö¡¡¡ö¡ö¡ö¡¡¡ö¡¡¡ö¡¡¡ö¡ö¡ö¡¡¡ö¡ö¡ö¡¡¡ö¡¡¡ö¡¡¡ö¡¡¡ö¡¡¡ö¡ö¡ö¡ö¡ö¡ö¡ö¡¡¡ö¡ö¡ö¡¡¡ö¡¡¡ö¡¡¡ö¡ö¡ö¡¡¡ö¡¡¡ö¡¡¡ö¡¡¡ö¡¡¡ö¡¡¡ö¡¡¡ö¡¡¡ö¡¡¡ö¡¡¡ö¡ö¡ö¡¡¡ö¡ö¡ö¡ö¡ö¡ö¡ö¡ö¡ö¡ö¡ö
¡ö¡¡¡ö¡¡¡ö¡¡¡ö¡¡¡¡¡¡¡ö¡¡¡¡¡¡¡ö¡¡¡¡¡¡¡¡¡¡¡¡¡¡¡ö¡¡¡¡¡¡¡ö¡¡¡ö¡¡¡ö¡¡¡¡¡¡¡ö¡¡¡¡¡¡¡ö¡¡¡ö¡¡¡ö¡¡¡ö¡¡¡ö¡¡¡¡¡¡¡¡¡¡¡¡¡¡¡ö¡¡¡¡¡¡¡ö¡¡¡ö¡¡¡ö¡¡¡¡¡¡¡ö¡¡¡ö¡¡¡ö¡¡¡ö¡¡¡ö¡¡¡ö¡¡¡ö¡¡¡ö¡¡¡ö¡¡¡ö¡¡¡¡¡¡¡¡¡¡¡¡¡¡¡¡¡¡¡¡¡¡¡ö¡¡¡¡¡¡¡ö
¡ö¡¡¡ö¡¡¡ö¡ö¡ö¡ö¡ö¡ö¡ö¡¡¡ö¡ö¡ö¡ö¡ö¡¡¡ö¡ö¡ö¡ö¡ö¡ö¡ö¡ö¡ö¡ö¡ö¡¡¡ö¡ö¡ö¡ö¡ö¡ö¡ö¡ö¡ö¡ö¡ö¡¡¡ö¡¡¡ö¡ö¡ö¡¡¡ö¡¡¡ö¡¡¡ö¡¡¡ö¡¡¡ö¡ö¡ö¡¡¡ö¡¡¡ö¡ö¡ö¡ö¡ö¡ö¡ö¡ö¡ö¡¡¡ö¡ö¡ö¡¡¡ö¡¡¡ö¡¡¡ö¡ö¡ö¡¡¡ö¡ö¡ö¡ö¡ö¡ö¡ö¡ö¡ö¡ö¡ö¡ö¡ö¡¡¡ö¡ö¡ö
¡ö¡¡¡ö¡¡¡ö¡¡¡¡¡¡¡¡¡¡¡¡¡¡¡¡¡¡¡ö¡¡¡¡¡¡¡¡¡¡¡¡¡¡¡¡¡¡¡¡¡¡¡ö¡¡¡¡¡¡¡¡¡¡¡¡¡¡¡¡¡¡¡¡¡¡¡¡¡¡¡ö¡¡¡ö¡¡¡¡¡¡¡ö¡¡¡ö¡¡¡ö¡¡¡ö¡¡¡ö¡¡¡ö¡¡¡¡¡¡¡ö¡¡¡¡¡¡¡¡¡¡¡¡¡¡¡¡¡¡¡ö¡¡¡¡¡¡¡ö¡¡¡ö¡¡¡ö¡¡¡¡¡¡¡ö¡¡¡ö¡¡¡ö¡¡¡¡¡¡¡¡¡¡¡¡¡¡¡ö¡¡¡ö¡¡¡¡¡¡¡ö
¡ö¡¡¡ö¡¡¡ö¡¡¡ö¡¡¡ö¡ö¡ö¡ö¡ö¡ö¡ö¡ö¡ö¡¡¡ö¡ö¡ö¡ö¡ö¡¡¡ö¡¡¡ö¡¡¡ö¡¡¡ö¡¡¡ö¡ö¡ö¡¡¡ö¡¡¡ö¡ö¡ö¡ö¡ö¡¡¡ö¡¡¡ö¡¡¡ö¡¡¡ö¡¡¡ö¡¡¡ö¡ö¡ö¡ö¡ö¡ö¡ö¡¡¡ö¡ö¡ö¡¡¡ö¡¡¡ö¡ö¡ö¡¡¡ö¡ö¡ö¡¡¡ö¡¡¡ö¡¡¡ö¡¡¡ö¡ö¡ö¡¡¡ö¡ö¡ö¡¡¡ö¡ö¡ö¡¡¡ö¡¡¡ö¡ö¡ö¡¡¡ö
¡ö¡¡¡ö¡¡¡ö¡¡¡ö¡¡¡ö¡¡¡¡¡¡¡¡¡¡¡ö¡¡¡ö¡¡¡¡¡¡¡¡¡¡¡ö¡¡¡ö¡¡¡ö¡¡¡ö¡¡¡ö¡¡¡¡¡¡¡ö¡¡¡ö¡¡¡ö¡¡¡ö¡¡¡¡¡¡¡ö¡¡¡ö¡¡¡ö¡¡¡ö¡¡¡ö¡¡¡¡¡¡¡¡¡¡¡¡¡¡¡ö¡¡¡¡¡¡¡ö¡¡¡ö¡¡¡ö¡¡¡ö¡¡¡¡¡¡¡ö¡¡¡ö¡¡¡ö¡¡¡ö¡¡¡¡¡¡¡¡¡¡¡¡¡¡¡¡¡¡¡¡¡¡¡ö¡¡¡¡¡¡¡¡¡¡¡¡¡¡¡ö
¡ö¡ö¡ö¡¡¡ö¡ö¡ö¡ö¡ö¡ö¡ö¡ö¡ö¡¡¡ö¡¡¡ö¡¡¡ö¡¡¡ö¡ö¡ö¡ö¡ö¡¡¡ö¡ö¡ö¡¡¡ö¡¡¡ö¡¡¡ö¡¡¡ö¡ö¡ö¡¡¡ö¡ö¡ö¡¡¡ö¡ö¡ö¡¡¡ö¡ö¡ö¡¡¡ö¡¡¡ö¡ö¡ö¡¡¡ö¡¡¡ö¡ö¡ö¡ö¡ö¡ö¡ö¡ö¡ö¡¡¡ö¡ö¡ö¡ö¡ö¡¡¡ö¡¡¡ö¡¡¡ö¡¡¡ö¡¡¡ö¡ö¡ö¡¡¡ö¡¡¡ö¡¡¡ö¡¡¡ö¡ö¡ö¡ö¡ö¡ö¡ö
¡ö¡¡¡¡¡¡¡ö¡¡¡¡¡¡¡¡¡¡¡¡¡¡¡¡¡¡¡¡¡¡¡¡¡¡¡ö¡¡¡¡¡¡¡¡¡¡¡ö¡¡¡¡¡¡¡ö¡¡¡ö¡¡¡ö¡¡¡ö¡¡¡¡¡¡¡¡¡¡¡ö¡¡¡ö¡¡¡ö¡¡¡ö¡¡¡¡¡¡¡ö¡¡¡ö¡¡¡¡¡¡¡ö¡¡¡ö¡¡¡¡¡¡¡¡¡¡¡¡¡¡¡¡¡¡¡¡¡¡¡¡¡¡¡ö¡¡¡ö¡¡¡ö¡¡¡ö¡¡¡ö¡¡¡ö¡¡¡ö¡¡¡¡¡¡¡ö¡¡¡ö¡¡¡ö¡¡¡¡¡¡¡¡¡¡¡¡¡¡¡ö
¡ö¡¡¡ö¡¡¡ö¡¡¡ö¡ö¡ö¡ö¡ö¡¡¡ö¡¡¡ö¡¡¡ö¡ö¡ö¡¡¡ö¡¡¡ö¡¡¡ö¡ö¡ö¡ö¡ö¡¡¡ö¡¡¡ö¡¡¡ö¡ö¡ö¡ö¡ö¡ö¡ö¡¡¡ö¡ö¡ö¡¡¡ö¡¡¡ö¡ö¡ö¡¡¡ö¡¡¡ö¡ö¡ö¡ö¡ö¡ö¡ö¡ö¡ö¡¡¡ö¡ö¡ö¡¡¡ö¡ö¡ö¡ö¡ö¡¡¡ö¡ö¡ö¡ö¡ö¡¡¡ö¡¡¡ö¡ö¡ö¡ö¡ö¡¡¡ö¡¡¡ö¡ö¡ö¡ö¡ö¡ö¡ö¡ö¡ö¡ö¡ö
¡ö¡¡¡ö¡¡¡ö¡¡¡ö¡¡¡¡¡¡¡¡¡¡¡ö¡¡¡ö¡¡¡¡¡¡¡ö¡¡¡ö¡¡¡ö¡¡¡ö¡¡¡¡¡¡¡¡¡¡¡ö¡¡¡ö¡¡¡¡¡¡¡¡¡¡¡¡¡¡¡¡¡¡¡¡¡¡¡¡¡¡¡ö¡¡¡¡¡¡¡ö¡¡¡ö¡¡¡ö¡¡¡¡¡¡¡¡¡¡¡¡¡¡¡ö¡¡¡ö¡¡¡¡¡¡¡¡¡¡¡¡¡¡¡¡¡¡¡¡¡¡¡¡¡¡¡ö¡¡¡ö¡¡¡¡¡¡¡ö¡¡¡¡¡¡¡ö¡¡¡¡¡¡¡¡¡¡¡¡¡¡¡¡¡¡¡¡¡¡¡ö
¡ö¡¡¡ö¡¡¡ö¡¡¡ö¡ö¡ö¡¡¡ö¡ö¡ö¡¡¡ö¡¡¡ö¡¡¡ö¡¡¡ö¡ö¡ö¡ö¡ö¡¡¡ö¡ö¡ö¡¡¡ö¡¡¡ö¡¡¡ö¡¡¡ö¡ö¡ö¡¡¡ö¡¡¡ö¡ö¡ö¡¡¡ö¡¡¡ö¡ö¡ö¡ö¡ö¡ö¡ö¡¡¡ö¡ö¡ö¡ö¡ö¡¡¡ö¡¡¡ö¡¡¡ö¡¡¡ö¡ö¡ö¡ö¡ö¡ö¡ö¡ö¡ö¡ö¡ö¡ö¡ö¡¡¡ö¡ö¡ö¡¡¡ö¡¡¡ö¡ö¡ö¡ö¡ö¡¡¡ö¡ö¡ö¡ö¡ö¡ö¡ö
¡ö¡¡¡ö¡¡¡ö¡¡¡ö¡¡¡¡¡¡¡ö¡¡¡¡¡¡¡ö¡¡¡ö¡¡¡ö¡¡¡¡¡¡¡ö¡¡¡ö¡¡¡¡¡¡¡ö¡¡¡ö¡¡¡ö¡¡¡ö¡¡¡¡¡¡¡ö¡¡¡ö¡¡¡¡¡¡¡ö¡¡¡ö¡¡¡¡¡¡¡¡¡¡¡¡¡¡¡¡¡¡¡¡¡¡¡¡¡¡¡ö¡¡¡ö¡¡¡ö¡¡¡ö¡¡¡¡¡¡¡¡¡¡¡¡¡¡¡ö¡¡¡¡¡¡¡¡¡¡¡ö¡¡¡ö¡¡¡¡¡¡¡ö¡¡¡¡¡¡¡¡¡¡¡ö¡¡¡¡¡¡¡ö¡¡¡¡¡¡¡ö
¡ö¡¡¡ö¡ö¡ö¡¡¡ö¡¡¡ö¡¡¡ö¡ö¡ö¡¡¡ö¡¡¡ö¡ö¡ö¡ö¡ö¡ö¡ö¡¡¡ö¡ö¡ö¡¡¡ö¡ö¡ö¡ö¡ö¡¡¡ö¡¡¡ö¡¡¡ö¡ö¡ö¡¡¡ö¡¡¡ö¡ö¡ö¡ö¡ö¡¡¡ö¡¡¡ö¡¡¡ö¡ö¡ö¡ö¡ö¡¡¡ö¡¡¡ö¡ö¡ö¡¡¡ö¡¡¡ö¡ö¡ö¡ö¡ö¡ö¡ö¡¡¡ö¡ö¡ö¡¡¡ö¡ö¡ö¡ö¡ö¡¡¡ö¡¡¡ö¡ö¡ö¡¡¡ö¡¡¡ö¡ö¡ö¡¡¡ö¡ö¡ö
¡ö¡¡¡¡¡¡¡ö¡¡¡ö¡¡¡ö¡¡¡ö¡¡¡¡¡¡¡ö¡¡¡¡¡¡¡¡¡¡¡¡¡¡¡¡¡¡¡¡¡¡¡ö¡¡¡¡¡¡¡¡¡¡¡ö¡¡¡ö¡¡¡ö¡¡¡ö¡¡¡¡¡¡¡ö¡¡¡¡¡¡¡¡¡¡¡ö¡¡¡ö¡¡¡ö¡¡¡¡¡¡¡ö¡¡¡¡¡¡¡ö¡¡¡¡¡¡¡ö¡¡¡ö¡¡¡¡¡¡¡ö¡¡¡¡¡¡¡¡¡¡¡¡¡¡¡ö¡¡¡ö¡¡¡¡¡¡¡¡¡¡¡ö¡¡¡¡¡¡¡ö¡¡¡ö¡¡¡¡¡¡¡¡¡¡¡¡¡¡¡ö
¡ö¡¡¡ö¡¡¡ö¡¡¡ö¡¡¡ö¡¡¡ö¡¡¡ö¡ö¡ö¡¡¡ö¡ö¡ö¡¡¡ö¡¡¡ö¡¡¡ö¡ö¡ö¡¡¡ö¡ö¡ö¡ö¡ö¡¡¡ö¡¡¡ö¡ö¡ö¡ö¡ö¡ö¡ö¡ö¡ö¡¡¡ö¡ö¡ö¡¡¡ö¡ö¡ö¡¡¡ö¡ö¡ö¡¡¡ö¡ö¡ö¡¡¡ö¡ö¡ö¡¡¡ö¡ö¡ö¡¡¡ö¡¡¡ö¡ö¡ö¡ö¡ö¡ö¡ö¡¡¡ö¡ö¡ö¡¡¡ö¡¡¡ö¡¡¡ö¡ö¡ö¡¡¡ö¡¡¡ö¡¡¡ö¡¡¡ö¡¡¡ö
¡ö¡¡¡ö¡¡¡ö¡¡¡ö¡¡¡ö¡¡¡ö¡¡¡ö¡¡¡¡¡¡¡¡¡¡¡ö¡¡¡ö¡¡¡ö¡¡¡¡¡¡¡ö¡¡¡¡¡¡¡¡¡¡¡ö¡¡¡ö¡¡¡ö¡¡¡¡¡¡¡ö¡¡¡¡¡¡¡ö¡¡¡¡¡¡¡ö¡¡¡¡¡¡¡ö¡¡¡ö¡¡¡¡¡¡¡¡¡¡¡ö¡¡¡ö¡¡¡¡¡¡¡¡¡¡¡ö¡¡¡¡¡¡¡¡¡¡¡¡¡¡¡¡¡¡¡ö¡¡¡ö¡¡¡ö¡¡¡ö¡¡¡ö¡¡¡ö¡¡¡¡¡¡¡ö¡¡¡ö¡¡¡ö¡¡¡ö¡¡¡ö
¡ö¡ö¡ö¡¡¡ö¡ö¡ö¡¡¡ö¡¡¡ö¡ö¡ö¡¡¡ö¡ö¡ö¡¡¡ö¡ö¡ö¡¡¡ö¡¡¡ö¡ö¡ö¡¡¡ö¡¡¡ö¡ö¡ö¡¡¡ö¡ö¡ö¡¡¡ö¡ö¡ö¡¡¡ö¡ö¡ö¡¡¡ö¡¡¡ö¡ö¡ö¡¡¡ö¡¡¡ö¡ö¡ö¡ö¡ö¡ö¡ö¡¡¡ö¡¡¡ö¡ö¡ö¡¡¡ö¡ö¡ö¡ö¡ö¡ö¡ö¡ö¡ö¡ö¡ö¡ö¡ö¡¡¡ö¡ö¡ö¡¡¡ö¡ö¡ö¡¡¡ö¡¡¡ö¡¡¡ö¡¡¡ö¡ö¡ö¡ö¡ö
¡ö¡¡¡¡¡¡¡ö¡¡¡¡¡¡¡ö¡¡¡ö¡¡¡¡¡¡¡ö¡¡¡¡¡¡¡¡¡¡¡ö¡¡¡ö¡¡¡ö¡¡¡¡¡¡¡ö¡¡¡¡¡¡¡ö¡¡¡¡¡¡¡¡¡¡¡¡¡¡¡¡¡¡¡¡¡¡¡ö¡¡¡ö¡¡¡¡¡¡¡ö¡¡¡ö¡¡¡ö¡¡¡¡¡¡¡¡¡¡¡ö¡¡¡ö¡¡¡¡¡¡¡ö¡¡¡¡¡¡¡¡¡¡¡¡¡¡¡¡¡¡¡¡¡¡¡¡¡¡¡¡¡¡¡¡¡¡¡ö¡¡¡¡¡¡¡ö¡¡¡ö¡¡¡ö¡¡¡ö¡¡¡¡¡¡¡¡¡¡¡ö
¡ö¡ö¡ö¡¡¡ö¡ö¡ö¡¡¡ö¡ö¡ö¡ö¡ö¡¡¡ö¡¡¡ö¡¡¡ö¡¡¡ö¡ö¡ö¡¡¡ö¡¡¡ö¡¡¡ö¡¡¡ö¡¡¡ö¡ö¡ö¡¡¡ö¡¡¡ö¡¡¡ö¡¡¡ö¡¡¡ö¡ö¡ö¡ö¡ö¡ö¡ö¡¡¡ö¡¡¡ö¡¡¡ö¡ö¡ö¡ö¡ö¡ö¡ö¡¡¡ö¡ö¡ö¡¡¡ö¡¡¡ö¡ö¡ö¡ö¡ö¡¡¡ö¡ö¡ö¡ö¡ö¡ö¡ö¡¡¡ö¡¡¡ö¡ö¡ö¡ö¡ö¡ö¡ö¡¡¡ö¡ö¡ö¡ö¡ö¡ö¡ö
¡ö¡¡¡¡¡¡¡ö¡¡¡¡¡¡¡ö¡¡¡¡¡¡¡¡¡¡¡ö¡¡¡ö¡¡¡ö¡¡¡¡¡¡¡ö¡¡¡ö¡¡¡ö¡¡¡ö¡¡¡ö¡¡¡¡¡¡¡ö¡¡¡ö¡¡¡ö¡¡¡ö¡¡¡ö¡¡¡¡¡¡¡¡¡¡¡¡¡¡¡ö¡¡¡ö¡¡¡¡¡¡¡¡¡¡¡¡¡¡¡¡¡¡¡ö¡¡¡¡¡¡¡ö¡¡¡ö¡¡¡¡¡¡¡¡¡¡¡ö¡¡¡¡¡¡¡¡¡¡¡¡¡¡¡ö¡¡¡ö¡¡¡¡¡¡¡ö¡¡¡¡¡¡¡¡¡¡¡¡¡¡¡¡¡¡¡¡¡¡¡ö
¡ö¡ö¡ö¡¡¡ö¡ö¡ö¡ö¡ö¡¡¡ö¡¡¡ö¡ö¡ö¡¡¡ö¡¡¡ö¡¡¡ö¡ö¡ö¡ö¡ö¡¡¡ö¡¡¡ö¡ö¡ö¡¡¡ö¡¡¡ö¡¡¡ö¡¡¡ö¡¡¡ö¡¡¡ö¡¡¡ö¡¡¡ö¡¡¡ö¡ö¡ö¡¡¡ö¡¡¡ö¡ö¡ö¡ö¡ö¡¡¡ö¡ö¡ö¡¡¡ö¡ö¡ö¡¡¡ö¡ö¡ö¡ö¡ö¡¡¡ö¡¡¡ö¡¡¡ö¡ö¡ö¡ö¡ö¡ö¡ö¡ö¡ö¡ö¡ö¡¡¡ö¡¡¡ö¡¡¡ö¡ö¡ö¡ö¡ö¡¡¡ö
¡ö¡¡¡¡¡¡¡ö¡¡¡¡¡¡¡¡¡¡¡ö¡¡¡ö¡¡¡¡¡¡¡ö¡¡¡ö¡¡¡¡¡¡¡ö¡¡¡¡¡¡¡ö¡¡¡¡¡¡¡ö¡¡¡ö¡¡¡ö¡¡¡ö¡¡¡ö¡¡¡ö¡¡¡ö¡¡¡ö¡¡¡ö¡¡¡¡¡¡¡ö¡¡¡ö¡¡¡¡¡¡¡¡¡¡¡ö¡¡¡¡¡¡¡ö¡¡¡¡¡¡¡ö¡¡¡¡¡¡¡¡¡¡¡ö¡¡¡ö¡¡¡ö¡¡¡¡¡¡¡¡¡¡¡¡¡¡¡¡¡¡¡¡¡¡¡ö¡¡¡ö¡¡¡ö¡¡¡¡¡¡¡¡¡¡¡ö¡¡¡ö
¡ö¡¡¡ö¡¡¡ö¡ö¡ö¡ö¡ö¡¡¡ö¡¡¡ö¡¡¡ö¡¡¡ö¡ö¡ö¡¡¡ö¡ö¡ö¡¡¡ö¡ö¡ö¡ö¡ö¡¡¡ö¡ö¡ö¡¡¡ö¡¡¡ö¡ö¡ö¡¡¡ö¡¡¡ö¡ö¡ö¡ö¡ö¡¡¡ö¡¡¡ö¡ö¡ö¡¡¡ö¡¡¡ö¡¡¡ö¡ö¡ö¡ö¡ö¡ö¡ö¡ö¡ö¡¡¡ö¡ö¡ö¡ö¡ö¡¡¡ö¡¡¡ö¡¡¡ö¡¡¡ö¡ö¡ö¡ö¡ö¡¡¡ö¡ö¡ö¡ö¡ö¡ö¡ö¡¡¡ö¡ö¡ö¡¡¡ö¡¡¡ö
¡ö¡¡¡ö¡¡¡ö¡¡¡¡¡¡¡¡¡¡¡ö¡¡¡ö¡¡¡ö¡¡¡ö¡¡¡¡¡¡¡¡¡¡¡ö¡¡¡¡¡¡¡¡¡¡¡ö¡¡¡¡¡¡¡ö¡¡¡ö¡¡¡ö¡¡¡ö¡¡¡ö¡¡¡¡¡¡¡¡¡¡¡ö¡¡¡ö¡¡¡¡¡¡¡ö¡¡¡ö¡¡¡ö¡¡¡¡¡¡¡¡¡¡¡¡¡¡¡¡¡¡¡ö¡¡¡¡¡¡¡¡¡¡¡ö¡¡¡ö¡¡¡ö¡¡¡ö¡¡¡¡¡¡¡¡¡¡¡ö¡¡¡¡¡¡¡¡¡¡¡¡¡¡¡ö¡¡¡¡¡¡¡ö¡¡¡ö¡¡¡ö
¡ö¡¡¡ö¡ö¡ö¡ö¡ö¡ö¡ö¡¡¡ö¡ö¡ö¡¡¡ö¡¡¡ö¡¡¡ö¡¡¡ö¡ö¡ö¡¡¡ö¡¡¡ö¡¡¡ö¡¡¡ö¡¡¡ö¡¡¡ö¡¡¡ö¡¡¡ö¡ö¡ö¡¡¡ö¡¡¡ö¡¡¡ö¡ö¡ö¡ö¡ö¡¡¡ö¡ö¡ö¡¡¡ö¡ö¡ö¡ö¡ö¡ö¡ö¡¡¡ö¡ö¡ö¡ö¡ö¡¡¡ö¡ö¡ö¡ö¡ö¡ö¡ö¡¡¡ö¡ö¡ö¡¡¡ö¡ö¡ö¡¡¡ö¡ö¡ö¡¡¡ö¡¡¡ö¡¡¡ö¡ö¡ö¡¡¡ö¡ö¡ö
¡ö¡¡¡¡¡¡¡ö¡¡¡¡¡¡¡¡¡¡¡¡¡¡¡ö¡¡¡ö¡¡¡ö¡¡¡ö¡¡¡¡¡¡¡ö¡¡¡ö¡¡¡ö¡¡¡ö¡¡¡ö¡¡¡ö¡¡¡ö¡¡¡¡¡¡¡ö¡¡¡¡¡¡¡ö¡¡¡ö¡¡¡¡¡¡¡¡¡¡¡ö¡¡¡ö¡¡¡¡¡¡¡¡¡¡¡¡¡¡¡¡¡¡¡ö¡¡¡¡¡¡¡¡¡¡¡ö¡¡¡¡¡¡¡¡¡¡¡ö¡¡¡¡¡¡¡¡¡¡¡ö¡¡¡ö¡¡¡¡¡¡¡ö¡¡¡¡¡¡¡ö¡¡¡ö¡¡¡¡¡¡¡ö¡¡¡¡¡¡¡ö
¡ö¡ö¡ö¡ö¡ö¡ö¡ö¡ö¡ö¡¡¡ö¡¡¡ö¡¡¡ö¡ö¡ö¡¡¡ö¡¡¡ö¡¡¡ö¡¡¡ö¡ö¡ö¡ö¡ö¡ö¡ö¡¡¡ö¡ö¡ö¡¡¡ö¡ö¡ö¡¡¡ö¡ö¡ö¡ö¡ö¡ö¡ö¡ö¡ö¡¡¡ö¡ö¡ö¡¡¡ö¡¡¡ö¡¡¡ö¡ö¡ö¡¡¡ö¡¡¡ö¡¡¡ö¡ö¡ö¡¡¡ö¡ö¡ö¡ö¡ö¡ö¡ö¡¡¡ö¡ö¡ö¡ö¡ö¡ö¡ö¡¡¡ö¡ö¡ö¡¡¡ö¡¡¡ö¡¡¡ö¡¡¡ö¡¡¡ö¡¡¡ö
¡ö¡¡¡¡¡¡¡¡¡¡¡¡¡¡¡¡¡¡¡ö¡¡¡ö¡¡¡ö¡¡¡¡¡¡¡ö¡¡¡ö¡¡¡ö¡¡¡¡¡¡¡¡¡¡¡¡¡¡¡ö¡¡¡¡¡¡¡ö¡¡¡¡¡¡¡ö¡¡¡¡¡¡¡¡¡¡¡ö¡¡¡¡¡¡¡ö¡¡¡ö¡¡¡¡¡¡¡ö¡¡¡ö¡¡¡¡¡¡¡ö¡¡¡ö¡¡¡ö¡¡¡¡¡¡¡ö¡¡¡¡¡¡¡¡¡¡¡ö¡¡¡¡¡¡¡¡¡¡¡ö¡¡¡¡¡¡¡ö¡¡¡¡¡¡¡ö¡¡¡ö¡¡¡ö¡¡¡ö¡¡¡ö¡¡¡ö¡¡¡ö
¡ö¡¡¡ö¡¡¡ö¡ö¡ö¡¡¡ö¡¡¡ö¡ö¡ö¡¡¡ö¡¡¡ö¡¡¡ö¡¡¡ö¡¡¡ö¡¡¡ö¡¡¡ö¡¡¡ö¡ö¡ö¡¡¡ö¡¡¡ö¡ö¡ö¡¡¡ö¡ö¡ö¡ö¡ö¡ö¡ö¡¡¡ö¡ö¡ö¡¡¡ö¡¡¡ö¡¡¡ö¡¡¡ö¡ö¡ö¡¡¡ö¡¡¡ö¡ö¡ö¡ö¡ö¡ö¡ö¡ö¡ö¡¡¡ö¡ö¡ö¡ö¡ö¡¡¡ö¡ö¡ö¡¡¡ö¡ö¡ö¡¡¡ö¡ö¡ö¡¡¡ö¡ö¡ö¡ö¡ö¡ö¡ö¡¡¡ö¡¡¡ö
¡ö¡¡¡ö¡¡¡ö¡¡¡¡¡¡¡ö¡¡¡ö¡¡¡¡¡¡¡ö¡¡¡ö¡¡¡ö¡¡¡ö¡¡¡ö¡¡¡ö¡¡¡ö¡¡¡¡¡¡¡ö¡¡¡ö¡¡¡¡¡¡¡ö¡¡¡¡¡¡¡¡¡¡¡¡¡¡¡¡¡¡¡ö¡¡¡¡¡¡¡ö¡¡¡ö¡¡¡ö¡¡¡¡¡¡¡ö¡¡¡ö¡¡¡¡¡¡¡¡¡¡¡¡¡¡¡¡¡¡¡ö¡¡¡¡¡¡¡¡¡¡¡ö¡¡¡¡¡¡¡¡¡¡¡¡¡¡¡ö¡¡¡¡¡¡¡ö¡¡¡¡¡¡¡¡¡¡¡ö¡¡¡¡¡¡¡ö¡¡¡ö
¡ö¡¡¡ö¡ö¡ö¡ö¡ö¡¡¡ö¡¡¡ö¡¡¡ö¡¡¡ö¡¡¡ö¡¡¡ö¡¡¡ö¡¡¡ö¡¡¡ö¡¡¡ö¡¡¡ö¡¡¡ö¡¡¡ö¡ö¡ö¡¡¡ö¡¡¡ö¡ö¡ö¡¡¡ö¡¡¡ö¡¡¡ö¡¡¡ö¡ö¡ö¡¡¡ö¡ö¡ö¡¡¡ö¡¡¡ö¡ö¡ö¡¡¡ö¡¡¡ö¡¡¡ö¡ö¡ö¡ö¡ö¡ö¡ö¡¡¡ö¡¡¡ö¡ö¡ö¡¡¡ö¡ö¡ö¡¡¡ö¡ö¡ö¡¡¡ö¡¡¡ö¡¡¡ö¡ö¡ö¡¡¡ö¡¡¡ö¡ö¡ö
¡ö¡¡¡ö¡¡¡¡¡¡¡¡¡¡¡ö¡¡¡ö¡¡¡ö¡¡¡ö¡¡¡ö¡¡¡ö¡¡¡ö¡¡¡ö¡¡¡ö¡¡¡ö¡¡¡ö¡¡¡ö¡¡¡¡¡¡¡ö¡¡¡ö¡¡¡¡¡¡¡ö¡¡¡ö¡¡¡ö¡¡¡ö¡¡¡¡¡¡¡ö¡¡¡ö¡¡¡¡¡¡¡ö¡¡¡¡¡¡¡ö¡¡¡ö¡¡¡ö¡¡¡ö¡¡¡¡¡¡¡¡¡¡¡ö¡¡¡ö¡¡¡¡¡¡¡ö¡¡¡¡¡¡¡ö¡¡¡¡¡¡¡ö¡¡¡ö¡¡¡ö¡¡¡¡¡¡¡ö¡¡¡ö¡¡¡¡¡¡¡ö
¡ö¡ö¡ö¡ö¡ö¡ö¡ö¡¡¡ö¡¡¡ö¡¡¡ö¡¡¡ö¡¡¡ö¡ö¡ö¡ö¡ö¡ö¡ö¡¡¡ö¡¡¡ö¡¡¡ö¡ö¡ö¡¡¡ö¡¡¡ö¡¡¡ö¡¡¡ö¡¡¡ö¡ö¡ö¡ö¡ö¡¡¡ö¡ö¡ö¡¡¡ö¡¡¡ö¡¡¡ö¡¡¡ö¡¡¡ö¡¡¡ö¡ö¡ö¡¡¡ö¡ö¡ö¡¡¡ö¡ö¡ö¡¡¡ö¡¡¡ö¡¡¡ö¡ö¡ö¡ö¡ö¡ö¡ö¡¡¡ö¡ö¡ö¡¡¡ö¡¡¡ö¡¡¡ö¡¡¡ö¡¡¡ö¡¡¡ö¡¡¡ö
¡ö¡¡¡¡¡¡¡¡¡¡¡¡¡¡¡ö¡¡¡ö¡¡¡ö¡¡¡ö¡¡¡¡¡¡¡ö¡¡¡¡¡¡¡¡¡¡¡ö¡¡¡ö¡¡¡¡¡¡¡ö¡¡¡ö¡¡¡ö¡¡¡ö¡¡¡ö¡¡¡¡¡¡¡¡¡¡¡ö¡¡¡¡¡¡¡ö¡¡¡ö¡¡¡ö¡¡¡ö¡¡¡ö¡¡¡ö¡¡¡ö¡¡¡¡¡¡¡¡¡¡¡¡¡¡¡¡¡¡¡ö¡¡¡ö¡¡¡ö¡¡¡¡¡¡¡¡¡¡¡¡¡¡¡ö¡¡¡¡¡¡¡ö¡¡¡ö¡¡¡ö¡¡¡ö¡¡¡ö¡¡¡ö¡¡¡ö¡¡¡ö
¡ö¡¡¡ö¡ö¡ö¡¡¡ö¡¡¡ö¡ö¡ö¡¡¡ö¡ö¡ö¡¡¡ö¡ö¡ö¡ö¡ö¡¡¡ö¡¡¡ö¡¡¡ö¡¡¡ö¡ö¡ö¡ö¡ö¡ö¡ö¡ö¡ö¡¡¡ö¡¡¡ö¡ö¡ö¡ö¡ö¡ö¡ö¡ö¡ö¡ö¡ö¡¡¡ö¡¡¡ö¡¡¡ö¡¡¡ö¡¡¡ö¡¡¡ö¡¡¡ö¡ö¡ö¡ö¡ö¡ö¡ö¡ö¡ö¡ö¡ö¡¡¡ö¡¡¡ö¡ö¡ö¡ö¡ö¡ö¡ö¡ö¡ö¡¡¡ö¡¡¡ö¡ö¡ö¡¡¡ö¡ö¡ö¡¡¡ö¡ö¡ö
¡ö¡¡¡ö¡¡¡¡¡¡¡ö¡¡¡¡¡¡¡ö¡¡¡¡¡¡¡ö¡¡¡¡¡¡¡¡¡¡¡ö¡¡¡ö¡¡¡ö¡¡¡ö¡¡¡¡¡¡¡¡¡¡¡¡¡¡¡ö¡¡¡¡¡¡¡ö¡¡¡¡¡¡¡¡¡¡¡¡¡¡¡¡¡¡¡ö¡¡¡ö¡¡¡ö¡¡¡ö¡¡¡ö¡¡¡ö¡¡¡ö¡¡¡ö¡¡¡¡¡¡¡¡¡¡¡¡¡¡¡¡¡¡¡¡¡¡¡ö¡¡¡ö¡¡¡¡¡¡¡¡¡¡¡¡¡¡¡¡¡¡¡ö¡¡¡ö¡¡¡¡¡¡¡ö¡¡¡ö¡¡¡¡¡¡¡¡¡¡¡ö
¡ö¡¡¡ö¡¡¡ö¡¡¡ö¡¡¡ö¡ö¡ö¡¡¡ö¡ö¡ö¡ö¡ö¡¡¡ö¡ö¡ö¡¡¡ö¡¡¡ö¡ö¡ö¡¡¡ö¡¡¡ö¡ö¡ö¡ö¡ö¡ö¡ö¡¡¡ö¡¡¡ö¡ö¡ö¡ö¡ö¡ö¡ö¡ö¡ö¡¡¡ö¡ö¡ö¡ö¡ö¡ö¡ö¡¡¡ö¡ö¡ö¡¡¡ö¡¡¡ö¡ö¡ö¡¡¡ö¡ö¡ö¡ö¡ö¡ö¡ö¡¡¡ö¡ö¡ö¡ö¡ö¡ö¡ö¡¡¡ö¡ö¡ö¡¡¡ö¡¡¡ö¡¡¡ö¡ö¡ö¡¡¡ö¡ö¡ö¡¡¡ö
¡ö¡¡¡ö¡¡¡ö¡¡¡ö¡¡¡¡¡¡¡ö¡¡¡¡¡¡¡ö¡¡¡¡¡¡¡¡¡¡¡ö¡¡¡ö¡¡¡¡¡¡¡ö¡¡¡ö¡¡¡¡¡¡¡ö¡¡¡ö¡¡¡¡¡¡¡ö¡¡¡¡¡¡¡¡¡¡¡¡¡¡¡¡¡¡¡¡¡¡¡ö¡¡¡¡¡¡¡ö¡¡¡¡¡¡¡¡¡¡¡ö¡¡¡ö¡¡¡ö¡¡¡¡¡¡¡¡¡¡¡¡¡¡¡¡¡¡¡ö¡¡¡¡¡¡¡¡¡¡¡¡¡¡¡ö¡¡¡¡¡¡¡ö¡¡¡ö¡¡¡ö¡¡¡¡¡¡¡ö¡¡¡ö¡¡¡¡¡¡¡ö
¡ö¡¡¡ö¡¡¡ö¡ö¡ö¡¡¡ö¡¡¡ö¡ö¡ö¡ö¡ö¡¡¡ö¡¡¡ö¡¡¡ö¡ö¡ö¡¡¡ö¡ö¡ö¡¡¡ö¡ö¡ö¡¡¡ö¡¡¡ö¡¡¡ö¡ö¡ö¡¡¡ö¡ö¡ö¡ö¡ö¡ö¡ö¡ö¡ö¡ö¡ö¡¡¡ö¡ö¡ö¡¡¡ö¡ö¡ö¡¡¡ö¡ö¡ö¡ö¡ö¡¡¡ö¡¡¡ö¡¡¡ö¡ö¡ö¡¡¡ö¡¡¡ö¡¡¡ö¡ö¡ö¡ö¡ö¡ö¡ö¡ö¡ö¡¡¡ö¡ö¡ö¡ö¡ö¡ö¡ö¡ö¡ö¡ö¡ö¡¡¡ö
¡ö¡¡¡ö¡¡¡¡¡¡¡ö¡¡¡ö¡¡¡¡¡¡¡¡¡¡¡ö¡¡¡ö¡¡¡ö¡¡¡¡¡¡¡ö¡¡¡¡¡¡¡ö¡¡¡¡¡¡¡ö¡¡¡ö¡¡¡¡¡¡¡ö¡¡¡¡¡¡¡¡¡¡¡¡¡¡¡¡¡¡¡¡¡¡¡¡¡¡¡¡¡¡¡¡¡¡¡ö¡¡¡¡¡¡¡ö¡¡¡¡¡¡¡¡¡¡¡ö¡¡¡ö¡¡¡ö¡¡¡¡¡¡¡ö¡¡¡ö¡¡¡ö¡¡¡¡¡¡¡¡¡¡¡¡¡¡¡¡¡¡¡ö¡¡¡¡¡¡¡ö¡¡¡ö¡¡¡¡¡¡¡ö¡¡¡¡¡¡¡ö
¡ö¡¡¡ö¡¡¡ö¡¡¡ö¡¡¡ö¡ö¡ö¡¡¡ö¡ö¡ö¡¡¡ö¡¡¡ö¡ö¡ö¡ö¡ö¡ö¡ö¡ö¡ö¡¡¡ö¡ö¡ö¡¡¡ö¡¡¡ö¡ö¡ö¡ö¡ö¡¡¡ö¡ö¡ö¡ö¡ö¡¡¡ö¡ö¡ö¡¡¡ö¡¡¡ö¡¡¡ö¡ö¡ö¡ö¡ö¡ö¡ö¡ö¡ö¡ö¡ö¡¡¡ö¡ö¡ö¡¡¡ö¡¡¡ö¡¡¡ö¡ö¡ö¡¡¡ö¡ö¡ö¡¡¡ö¡ö¡ö¡ö¡ö¡¡¡ö¡¡¡ö¡¡¡ö¡¡¡ö¡¡¡ö¡ö¡ö¡¡¡ö
¡ö¡¡¡ö¡¡¡ö¡¡¡ö¡¡¡ö¡¡¡¡¡¡¡¡¡¡¡ö¡¡¡ö¡¡¡¡¡¡¡¡¡¡¡¡¡¡¡ö¡¡¡¡¡¡¡ö¡¡¡ö¡¡¡ö¡¡¡¡¡¡¡ö¡¡¡¡¡¡¡¡¡¡¡¡¡¡¡ö¡¡¡¡¡¡¡ö¡¡¡ö¡¡¡ö¡¡¡¡¡¡¡¡¡¡¡¡¡¡¡¡¡¡¡ö¡¡¡¡¡¡¡¡¡¡¡ö¡¡¡ö¡¡¡ö¡¡¡¡¡¡¡ö¡¡¡ö¡¡¡¡¡¡¡¡¡¡¡¡¡¡¡ö¡¡¡ö¡¡¡¡¡¡¡¡¡¡¡ö¡¡¡¡¡¡¡ö¡¡¡ö
¡ö¡ö¡ö¡¡¡ö¡¡¡ö¡¡¡ö¡¡¡ö¡ö¡ö¡¡¡ö¡¡¡ö¡ö¡ö¡ö¡ö¡¡¡ö¡¡¡ö¡¡¡ö¡¡¡ö¡¡¡ö¡ö¡ö¡¡¡ö¡ö¡ö¡¡¡ö¡¡¡ö¡ö¡ö¡¡¡ö¡ö¡ö¡ö¡ö¡¡¡ö¡ö¡ö¡¡¡ö¡ö¡ö¡¡¡ö¡ö¡ö¡ö¡ö¡ö¡ö¡ö¡ö¡¡¡ö¡¡¡ö¡ö¡ö¡¡¡ö¡ö¡ö¡¡¡ö¡¡¡ö¡ö¡ö¡¡¡ö¡¡¡ö¡ö¡ö¡ö¡ö¡ö¡ö¡ö¡ö¡¡¡ö¡ö¡ö¡¡¡ö
¡ö¡¡¡¡¡¡¡ö¡¡¡ö¡¡¡ö¡¡¡ö¡¡¡¡¡¡¡ö¡¡¡¡¡¡¡¡¡¡¡ö¡¡¡ö¡¡¡ö¡¡¡ö¡¡¡¡¡¡¡¡¡¡¡ö¡¡¡ö¡¡¡¡¡¡¡ö¡¡¡¡¡¡¡ö¡¡¡¡¡¡¡¡¡¡¡ö¡¡¡ö¡¡¡¡¡¡¡ö¡¡¡¡¡¡¡¡¡¡¡¡¡¡¡¡¡¡¡¡¡¡¡ö¡¡¡ö¡¡¡¡¡¡¡ö¡¡¡¡¡¡¡ö¡¡¡ö¡¡¡¡¡¡¡ö¡¡¡ö¡¡¡¡¡¡¡¡¡¡¡¡¡¡¡¡¡¡¡ö¡¡¡ö¡¡¡¡¡¡¡ö
¡ö¡¡¡ö¡ö¡ö¡¡¡ö¡¡¡ö¡¡¡ö¡¡¡ö¡¡¡ö¡¡¡ö¡ö¡ö¡ö¡ö¡¡¡ö¡¡¡ö¡¡¡ö¡ö¡ö¡¡¡ö¡ö¡ö¡¡¡ö¡ö¡ö¡ö¡ö¡¡¡ö¡ö¡ö¡¡¡ö¡ö¡ö¡ö¡ö¡¡¡ö¡ö¡ö¡¡¡ö¡¡¡ö¡¡¡ö¡¡¡ö¡¡¡ö¡ö¡ö¡¡¡ö¡¡¡ö¡¡¡ö¡¡¡ö¡ö¡ö¡ö¡ö¡¡¡ö¡¡¡ö¡¡¡ö¡¡¡ö¡¡¡ö¡ö¡ö¡¡¡ö¡ö¡ö¡ö¡ö¡¡¡ö¡¡¡ö¡¡¡ö
¡ö¡¡¡ö¡¡¡¡¡¡¡ö¡¡¡ö¡¡¡ö¡¡¡ö¡¡¡ö¡¡¡¡¡¡¡¡¡¡¡ö¡¡¡ö¡¡¡ö¡¡¡¡¡¡¡ö¡¡¡¡¡¡¡ö¡¡¡ö¡¡¡¡¡¡¡¡¡¡¡¡¡¡¡ö¡¡¡¡¡¡¡¡¡¡¡ö¡¡¡¡¡¡¡ö¡¡¡ö¡¡¡ö¡¡¡ö¡¡¡ö¡¡¡ö¡¡¡ö¡¡¡ö¡¡¡ö¡¡¡ö¡¡¡ö¡¡¡¡¡¡¡ö¡¡¡ö¡¡¡ö¡¡¡ö¡¡¡ö¡¡¡¡¡¡¡ö¡¡¡¡¡¡¡¡¡¡¡ö¡¡¡ö¡¡¡ö¡¡¡ö
¡ö¡¡¡ö¡ö¡ö¡¡¡ö¡¡¡ö¡¡¡ö¡ö¡ö¡ö¡ö¡¡¡ö¡ö¡ö¡ö¡ö¡¡¡ö¡ö¡ö¡ö¡ö¡ö¡ö¡¡¡ö¡¡¡ö¡ö¡ö¡¡¡ö¡ö¡ö¡¡¡ö¡¡¡ö¡ö¡ö¡¡¡ö¡¡¡ö¡¡¡ö¡ö¡ö¡¡¡ö¡¡¡ö¡ö¡ö¡ö¡ö¡ö¡ö¡¡¡ö¡¡¡ö¡ö¡ö¡¡¡ö¡ö¡ö¡¡¡ö¡ö¡ö¡¡¡ö¡¡¡ö¡¡¡ö¡¡¡ö¡¡¡ö¡¡¡ö¡ö¡ö¡ö¡ö¡¡¡ö¡ö¡ö¡ö¡ö¡¡¡ö
¡ö¡¡¡¡¡¡¡ö¡¡¡ö¡¡¡ö¡¡¡¡¡¡¡ö¡¡¡¡¡¡¡¡¡¡¡¡¡¡¡ö¡¡¡¡¡¡¡ö¡¡¡¡¡¡¡¡¡¡¡ö¡¡¡¡¡¡¡ö¡¡¡ö¡¡¡¡¡¡¡ö¡¡¡¡¡¡¡ö¡¡¡ö¡¡¡ö¡¡¡¡¡¡¡ö¡¡¡ö¡¡¡¡¡¡¡¡¡¡¡¡¡¡¡¡¡¡¡ö¡¡¡¡¡¡¡ö¡¡¡¡¡¡¡¡¡¡¡ö¡¡¡¡¡¡¡ö¡¡¡ö¡¡¡ö¡¡¡ö¡¡¡ö¡¡¡¡¡¡¡¡¡¡¡ö¡¡¡¡¡¡¡¡¡¡¡ö¡¡¡ö
¡ö¡¡¡ö¡ö¡ö¡ö¡ö¡¡¡ö¡ö¡ö¡¡¡ö¡ö¡ö¡¡¡ö¡¡¡ö¡¡¡ö¡¡¡ö¡ö¡ö¡¡¡ö¡¡¡ö¡¡¡ö¡¡¡ö¡ö¡ö¡ö¡ö¡ö¡ö¡¡¡ö¡¡¡ö¡ö¡ö¡¡¡ö¡¡¡ö¡ö¡ö¡ö¡ö¡¡¡ö¡¡¡ö¡¡¡ö¡¡¡ö¡ö¡ö¡¡¡ö¡ö¡ö¡ö¡ö¡¡¡ö¡¡¡ö¡ö¡ö¡¡¡ö¡¡¡ö¡¡¡ö¡¡¡ö¡¡¡ö¡¡¡ö¡ö¡ö¡¡¡ö¡¡¡ö¡ö¡ö¡ö¡ö¡¡¡ö¡ö¡ö
¡ö¡¡¡ö¡¡¡¡¡¡¡¡¡¡¡ö¡¡¡¡¡¡¡¡¡¡¡ö¡¡¡ö¡¡¡ö¡¡¡ö¡¡¡ö¡¡¡¡¡¡¡ö¡¡¡ö¡¡¡ö¡¡¡ö¡¡¡¡¡¡¡¡¡¡¡¡¡¡¡ö¡¡¡¡¡¡¡ö¡¡¡ö¡¡¡¡¡¡¡¡¡¡¡ö¡¡¡ö¡¡¡ö¡¡¡ö¡¡¡ö¡¡¡¡¡¡¡¡¡¡¡ö¡¡¡ö¡¡¡ö¡¡¡¡¡¡¡ö¡¡¡ö¡¡¡ö¡¡¡ö¡¡¡ö¡¡¡ö¡¡¡ö¡¡¡¡¡¡¡ö¡¡¡ö¡¡¡¡¡¡¡ö¡¡¡¡¡¡¡ö
¡ö¡ö¡ö¡¡¡ö¡ö¡ö¡¡¡ö¡¡¡ö¡¡¡ö¡¡¡ö¡¡¡ö¡¡¡ö¡¡¡ö¡¡¡ö¡¡¡ö¡¡¡ö¡¡¡ö¡ö¡ö¡ö¡ö¡¡¡ö¡ö¡ö¡¡¡ö¡¡¡ö¡¡¡ö¡¡¡ö¡ö¡ö¡¡¡ö¡¡¡ö¡ö¡ö¡ö¡ö¡¡¡ö¡ö¡ö¡¡¡ö¡¡¡ö¡¡¡ö¡ö¡ö¡¡¡ö¡¡¡ö¡¡¡ö¡¡¡ö¡ö¡ö¡¡¡ö¡ö¡ö¡ö¡ö¡ö¡ö¡ö¡ö¡¡¡ö¡¡¡ö¡¡¡ö¡¡¡ö¡ö¡ö¡¡¡ö¡¡¡ö
¡ö¡¡¡¡¡¡¡ö¡¡¡¡¡¡¡ö¡¡¡ö¡¡¡ö¡¡¡ö¡¡¡ö¡¡¡ö¡¡¡ö¡¡¡ö¡¡¡ö¡¡¡ö¡¡¡¡¡¡¡¡¡¡¡ö¡¡¡ö¡¡¡¡¡¡¡ö¡¡¡ö¡¡¡ö¡¡¡¡¡¡¡ö¡¡¡ö¡¡¡¡¡¡¡¡¡¡¡ö¡¡¡¡¡¡¡ö¡¡¡ö¡¡¡ö¡¡¡¡¡¡¡¡¡¡¡ö¡¡¡ö¡¡¡ö¡¡¡¡¡¡¡ö¡¡¡ö¡¡¡¡¡¡¡¡¡¡¡ö¡¡¡¡¡¡¡ö¡¡¡ö¡¡¡¡¡¡¡¡¡¡¡ö¡¡¡ö¡¡¡ö
¡ö¡¡¡ö¡ö¡ö¡¡¡ö¡¡¡ö¡¡¡ö¡¡¡ö¡¡¡ö¡¡¡ö¡¡¡ö¡ö¡ö¡¡¡ö¡ö¡ö¡¡¡ö¡ö¡ö¡¡¡ö¡ö¡ö¡ö¡ö¡ö¡ö¡¡¡ö¡¡¡ö¡¡¡ö¡ö¡ö¡¡¡ö¡ö¡ö¡¡¡ö¡¡¡ö¡ö¡ö¡¡¡ö¡ö¡ö¡ö¡ö¡ö¡ö¡¡¡ö¡ö¡ö¡ö¡ö¡¡¡ö¡ö¡ö¡ö¡ö¡ö¡ö¡ö¡ö¡¡¡ö¡ö¡ö¡ö¡ö¡ö¡ö¡ö¡ö¡¡¡ö¡¡¡ö¡ö¡ö¡ö¡ö¡¡¡ö¡ö¡ö
¡ö¡¡¡¡¡¡¡ö¡¡¡ö¡¡¡ö¡¡¡ö¡¡¡ö¡¡¡ö¡¡¡ö¡¡¡¡¡¡¡ö¡¡¡¡¡¡¡ö¡¡¡¡¡¡¡ö¡¡¡¡¡¡¡ö¡¡¡¡¡¡¡¡¡¡¡ö¡¡¡ö¡¡¡¡¡¡¡ö¡¡¡¡¡¡¡ö¡¡¡ö¡¡¡ö¡¡¡¡¡¡¡¡¡¡¡¡¡¡¡¡¡¡¡ö¡¡¡ö¡¡¡¡¡¡¡ö¡¡¡¡¡¡¡¡¡¡¡¡¡¡¡¡¡¡¡¡¡¡¡¡¡¡¡ö¡¡¡¡¡¡¡ö¡¡¡¡¡¡¡ö¡¡¡¡¡¡¡¡¡¡¡ö¡¡¡¡¡¡¡ö
¡ö¡¡¡ö¡ö¡ö¡¡¡ö¡¡¡ö¡ö¡ö¡¡¡ö¡¡¡ö¡¡¡ö¡¡¡ö¡¡¡ö¡ö¡ö¡ö¡ö¡¡¡ö¡ö¡ö¡¡¡ö¡ö¡ö¡¡¡ö¡ö¡ö¡¡¡ö¡¡¡ö¡¡¡ö¡¡¡ö¡ö¡ö¡ö¡ö¡¡¡ö¡ö¡ö¡¡¡ö¡ö¡ö¡¡¡ö¡¡¡ö¡ö¡ö¡¡¡ö¡¡¡ö¡ö¡ö¡¡¡ö¡¡¡ö¡ö¡ö¡¡¡ö¡ö¡ö¡¡¡ö¡ö¡ö¡¡¡ö¡ö¡ö¡ö¡ö¡¡¡ö¡¡¡ö¡ö¡ö¡¡¡ö¡ö¡ö¡¡¡ö
¡ö¡¡¡¡¡¡¡ö¡¡¡ö¡¡¡ö¡¡¡¡¡¡¡ö¡¡¡ö¡¡¡ö¡¡¡ö¡¡¡ö¡¡¡¡¡¡¡¡¡¡¡ö¡¡¡¡¡¡¡¡¡¡¡ö¡¡¡ö¡¡¡¡¡¡¡ö¡¡¡ö¡¡¡ö¡¡¡¡¡¡¡¡¡¡¡ö¡¡¡¡¡¡¡ö¡¡¡¡¡¡¡ö¡¡¡ö¡¡¡ö¡¡¡¡¡¡¡¡¡¡¡¡¡¡¡ö¡¡¡ö¡¡¡¡¡¡¡ö¡¡¡¡¡¡¡ö¡¡¡¡¡¡¡¡¡¡¡¡¡¡¡ö¡¡¡¡¡¡¡ö¡¡¡¡¡¡¡ö¡¡¡ö¡¡¡ö¡¡¡ö
¡ö¡¡¡ö¡¡¡ö¡¡¡ö¡¡¡ö¡¡¡ö¡¡¡ö¡¡¡ö¡ö¡ö¡¡¡ö¡ö¡ö¡¡¡ö¡¡¡ö¡ö¡ö¡ö¡ö¡¡¡ö¡ö¡ö¡ö¡ö¡ö¡ö¡ö¡ö¡¡¡ö¡¡¡ö¡¡¡ö¡¡¡ö¡¡¡ö¡¡¡ö¡¡¡ö¡¡¡ö¡¡¡ö¡¡¡ö¡¡¡ö¡ö¡ö¡¡¡ö¡¡¡ö¡¡¡ö¡¡¡ö¡ö¡ö¡¡¡ö¡¡¡ö¡ö¡ö¡¡¡ö¡¡¡ö¡¡¡ö¡¡¡ö¡¡¡ö¡¡¡ö¡¡¡ö¡ö¡ö¡ö¡ö¡¡¡ö¡ö¡ö
¡ö¡¡¡ö¡¡¡ö¡¡¡ö¡¡¡ö¡¡¡ö¡¡¡ö¡¡¡ö¡¡¡¡¡¡¡ö¡¡¡¡¡¡¡ö¡¡¡ö¡¡¡¡¡¡¡¡¡¡¡¡¡¡¡¡¡¡¡ö¡¡¡ö¡¡¡¡¡¡¡ö¡¡¡ö¡¡¡ö¡¡¡ö¡¡¡ö¡¡¡ö¡¡¡ö¡¡¡ö¡¡¡ö¡¡¡ö¡¡¡ö¡¡¡¡¡¡¡ö¡¡¡ö¡¡¡ö¡¡¡¡¡¡¡ö¡¡¡ö¡¡¡ö¡¡¡¡¡¡¡ö¡¡¡ö¡¡¡ö¡¡¡ö¡¡¡ö¡¡¡ö¡¡¡¡¡¡¡¡¡¡¡¡¡¡¡¡¡¡¡ö
¡ö¡¡¡ö¡¡¡ö¡ö¡ö¡ö¡ö¡¡¡ö¡¡¡ö¡ö¡ö¡ö¡ö¡ö¡ö¡¡¡ö¡¡¡ö¡ö¡ö¡ö¡ö¡ö¡ö¡¡¡ö¡ö¡ö¡ö¡ö¡¡¡ö¡ö¡ö¡ö¡ö¡ö¡ö¡¡¡ö¡¡¡ö¡¡¡ö¡¡¡ö¡ö¡ö¡ö¡ö¡¡¡ö¡¡¡ö¡¡¡ö¡ö¡ö¡¡¡ö¡ö¡ö¡ö¡ö¡¡¡ö¡ö¡ö¡ö¡ö¡¡¡ö¡ö¡ö¡¡¡ö¡¡¡ö¡¡¡ö¡¡¡ö¡¡¡ö¡¡¡ö¡¡¡ö¡¡¡ö¡ö¡ö¡ö¡ö¡¡¡ö
¡ö¡¡¡ö¡¡¡ö¡¡¡¡¡¡¡¡¡¡¡ö¡¡¡¡¡¡¡¡¡¡¡¡¡¡¡ö¡¡¡ö¡¡¡ö¡¡¡¡¡¡¡¡¡¡¡¡¡¡¡¡¡¡¡¡¡¡¡¡¡¡¡¡¡¡¡¡¡¡¡¡¡¡¡ö¡¡¡ö¡¡¡ö¡¡¡ö¡¡¡ö¡¡¡¡¡¡¡ö¡¡¡ö¡¡¡ö¡¡¡¡¡¡¡ö¡¡¡¡¡¡¡¡¡¡¡ö¡¡¡¡¡¡¡¡¡¡¡ö¡¡¡ö¡¡¡¡¡¡¡ö¡¡¡ö¡¡¡ö¡¡¡ö¡¡¡ö¡¡¡ö¡¡¡ö¡¡¡¡¡¡¡ö¡¡¡ö¡¡¡ö
¡ö¡¡¡ö¡¡¡ö¡ö¡ö¡¡¡ö¡¡¡ö¡ö¡ö¡ö¡ö¡¡¡ö¡ö¡ö¡¡¡ö¡¡¡ö¡ö¡ö¡ö¡ö¡ö¡ö¡¡¡ö¡ö¡ö¡ö¡ö¡¡¡ö¡¡¡ö¡ö¡ö¡ö¡ö¡¡¡ö¡¡¡ö¡ö¡ö¡¡¡ö¡¡¡ö¡ö¡ö¡ö¡ö¡ö¡ö¡ö¡ö¡ö¡ö¡ö¡ö¡ö¡ö¡¡¡ö¡ö¡ö¡ö¡ö¡¡¡ö¡¡¡ö¡ö¡ö¡¡¡ö¡¡¡ö¡ö¡ö¡ö¡ö¡ö¡ö¡ö¡ö¡ö¡ö¡¡¡ö¡ö¡ö¡¡¡ö¡ö¡ö
¡ö¡¡¡ö¡¡¡¡¡¡¡ö¡¡¡ö¡¡¡¡¡¡¡¡¡¡¡ö¡¡¡¡¡¡¡ö¡¡¡ö¡¡¡ö¡¡¡¡¡¡¡¡¡¡¡¡¡¡¡¡¡¡¡¡¡¡¡ö¡¡¡ö¡¡¡¡¡¡¡¡¡¡¡ö¡¡¡ö¡¡¡ö¡¡¡¡¡¡¡ö¡¡¡¡¡¡¡¡¡¡¡¡¡¡¡¡¡¡¡¡¡¡¡¡¡¡¡¡¡¡¡ö¡¡¡¡¡¡¡ö¡¡¡ö¡¡¡ö¡¡¡¡¡¡¡ö¡¡¡ö¡¡¡ö¡¡¡¡¡¡¡¡¡¡¡ö¡¡¡¡¡¡¡¡¡¡¡¡¡¡¡¡¡¡¡¡¡¡¡ö
¡ö¡¡¡ö¡ö¡ö¡ö¡ö¡ö¡ö¡¡¡ö¡¡¡ö¡ö¡ö¡¡¡ö¡¡¡ö¡¡¡ö¡¡¡ö¡ö¡ö¡¡¡ö¡ö¡ö¡ö¡ö¡¡¡ö¡¡¡ö¡ö¡ö¡¡¡ö¡ö¡ö¡ö¡ö¡¡¡ö¡ö¡ö¡¡¡ö¡¡¡ö¡¡¡ö¡ö¡ö¡ö¡ö¡ö¡ö¡¡¡ö¡¡¡ö¡ö¡ö¡¡¡ö¡ö¡ö¡ö¡ö¡¡¡ö¡ö¡ö¡ö¡ö¡¡¡ö¡¡¡ö¡ö¡ö¡¡¡ö¡ö¡ö¡ö¡ö¡¡¡ö¡ö¡ö¡¡¡ö¡ö¡ö¡ö¡ö¡ö¡ö
¡ö¡¡¡ö¡¡¡¡¡¡¡¡¡¡¡¡¡¡¡ö¡¡¡¡¡¡¡ö¡¡¡ö¡¡¡ö¡¡¡ö¡¡¡¡¡¡¡ö¡¡¡ö¡¡¡¡¡¡¡¡¡¡¡ö¡¡¡¡¡¡¡ö¡¡¡¡¡¡¡¡¡¡¡ö¡¡¡ö¡¡¡¡¡¡¡ö¡¡¡¡¡¡¡¡¡¡¡¡¡¡¡ö¡¡¡¡¡¡¡ö¡¡¡¡¡¡¡ö¡¡¡¡¡¡¡¡¡¡¡¡¡¡¡¡¡¡¡¡¡¡¡ö¡¡¡ö¡¡¡¡¡¡¡¡¡¡¡¡¡¡¡¡¡¡¡ö¡¡¡ö¡¡¡¡¡¡¡¡¡¡¡¡¡¡¡¡¡¡¡ö
¡ö¡ö¡ö¡ö¡ö¡ö¡ö¡ö¡ö¡ö¡ö¡ö¡ö¡ö¡ö¡ö¡ö¡ö¡ö¡ö¡ö¡ö¡ö¡ö¡ö¡ö¡ö¡ö¡ö¡ö¡ö¡ö¡ö¡ö¡ö¡ö¡ö¡ö¡ö¡ö¡ö¡ö¡ö¡ö¡ö¡ö¡ö¡ö¡ö¡ö¡ö¡ö¡ö¡ö¡ö¡ö¡ö¡ö¡ö¡ö¡ö¡ö¡ö¡ö¡ö¡ö¡ö¡ö¡ö¡ö¡ö¡ö¡ö¡ö¡ö¡ö¡ö¡ö¡ö¡ö¡ö¡ö¡ö¡ö¡ö¡ö¡ö¡ö¡ö¡ö¡ö¡ö¡ö¡ö¡ö¡ö¡ö¡ö¡ö¡¡¡ö
